396,397,397,397,397,397,397,397,397,397,397,397,397,397,397,397,397,397,397,397,397,397,397,397,397,397,397,397,397,397,397,397,397,397,397,397,397,397,397,397,397,397,397,397,397,397,397,397,397,397,397,397,397,397,397,397,397,397,397,397,397,397,397,397,397,397,397,397,397,397,397,397,397,397,397,396,397,397,397,398
419,419,419,419,419,419,419,419,419,419,419,419,419,419,419,419,419,419,419,419,419,419,419,419,419,419,419,419,419,419,419,419,419,419,419,419,419,419,419,419,419,419,419,419,419,419,419,419,419,419,419,419,419,419,419,419,419,419,419,419,419,419,419,419,419,419,419,419,419,419,419,419,419,419,419,418,419,399,423,420
438,438,419,419,419,419,419,419,419,419,419,419,419,419,419,419,419,419,419,419,419,419,419,419,419,419,419,419,419,419,419,419,419,419,419,419,419,419,419,419,419,419,419,419,419,419,419,419,419,419,419,419,419,419,419,419,419,419,419,419,419,419,419,419,419,423,424,419,419,419,419,419,423,424,419,418,419,421,419,420
272,438,438,438,438,438,438,419,419,419,438,438,438,438,419,419,419,438,438,438,438,438,438,438,419,419,419,419,419,419,419,419,419,419,438,438,419,419,419,419,419,419,419,419,419,419,419,419,419,419,419,438,438,419,419,419,419,419,419,419,419,419,419,419,419,445,446,419,419,419,419,419,445,446,419,418,419,443,419,420
272,438,438,438,438,438,438,438,438,438,438,438,438,438,438,438,438,438,272,272,272,272,272,438,438,438,438,438,438,438,438,438,438,438,438,438,438,438,438,438,438,438,419,419,419,419,419,419,419,419,438,438,438,419,419,419,419,419,419,419,419,419,419,419,419,419,419,419,419,419,419,419,419,419,419,440,441,441,441,442
272,272,272,272,272,272,272,272,272,272,272,272,272,272,272,272,272,272,272,272,166,166,272,272,272,438,438,438,438,438,438,272,272,272,272,272,272,272,438,438,438,438,438,438,438,438,438,438,438,438,438,272,272,438,438,438,438,438,438,438,419,419,419,419,419,419,419,419,419,419,419,419,419,419,419,419,419,419,419,419
166,272,272,272,272,272,272,272,272,272,272,272,272,272,272,272,272,166,166,166,166,166,166,166,272,272,438,438,438,272,272,272,166,166,272,272,272,272,166,272,272,272,272,438,438,272,272,438,272,272,272,272,272,272,272,166,438,438,438,438,438,438,438,438,419,419,419,419,419,419,419,419,419,419,419,419,419,419,419,419
166,166,166,166,166,272,272,166,166,166,166,166,166,166,166,166,166,166,166,166,166,166,166,166,166,272,272,272,272,272,166,166,166,166,166,166,166,272,272,272,272,272,272,272,272,272,272,272,272,166,166,166,166,166,272,272,438,438,272,272,272,438,438,438,438,419,419,419,419,419,419,419,419,419,419,419,419,419,419,419
166,166,166,166,166,166,166,166,166,166,166,166,166,166,166,166,166,166,166,166,166,166,166,166,166,166,272,272,272,166,166,166,166,166,166,166,166,166,272,272,272,166,272,166,166,166,166,166,166,166,166,166,166,166,166,272,272,272,272,272,272,272,438,438,438,438,438,438,438,438,438,438,438,438,419,419,419,419,419,419
166,166,166,166,166,166,166,166,166,166,166,166,166,166,166,166,166,166,166,166,166,166,166,166,166,166,166,166,166,166,166,166,166,166,166,166,166,166,166,272,272,166,166,166,166,166,166,166,166,166,166,166,166,166,166,166,272,272,166,166,166,272,272,272,272,272,438,438,438,438,438,438,438,438,438,438,438,438,438,438
166,166,166,166,166,166,166,166,166,166,166,166,166,166,166,166,166,166,166,166,166,166,166,270,166,166,166,166,166,166,166,166,166,166,166,166,166,170,171,166,166,166,166,166,166,166,166,166,166,166,166,166,166,166,166,166,166,166,166,166,166,166,166,272,272,272,272,272,438,438,438,438,438,438,438,438,438,438,438,438
166,166,166,166,166,166,166,166,166,166,166,166,166,166,34,166,166,166,166,166,166,166,166,166,166,166,166,166,166,166,166,166,166,166,166,166,166,192,193,166,166,166,166,166,166,166,166,166,166,166,166,34,166,166,166,166,166,166,166,166,166,166,166,166,272,272,272,272,272,272,438,438,438,438,438,438,438,438,438,438
166,166,166,166,166,166,166,166,166,166,166,166,166,166,166,166,166,166,166,166,166,166,166,166,166,166,166,166,166,166,166,166,166,166,166,166,166,166,166,166,166,166,166,166,166,166,166,166,166,166,166,166,166,166,166,166,166,166,166,166,166,166,166,166,166,166,272,272,166,272,272,272,272,438,438,438,438,438,438,438
166,166,166,166,166,166,166,166,166,166,166,166,166,166,166,166,166,166,166,166,166,166,166,166,166,166,166,166,166,166,166,166,166,166,166,166,166,166,166,166,166,166,166,166,166,166,166,166,166,166,166,166,166,166,166,166,166,166,166,166,166,166,166,166,166,166,166,272,272,272,272,272,272,272,272,272,438,438,438,438
166,166,166,166,166,166,166,166,166,166,166,166,166,166,166,166,166,166,166,166,166,166,166,166,166,166,166,166,166,166,166,166,166,166,166,166,166,166,166,166,166,166,166,166,166,166,166,166,166,166,166,166,166,166,166,166,166,166,166,166,166,166,166,166,166,166,166,166,166,272,272,272,272,272,272,272,272,272,438,438
166,166,166,166,166,166,166,166,166,166,166,166,166,166,166,34,166,166,166,166,166,166,166,166,166,166,166,166,273,273,273,166,166,166,166,166,166,166,166,166,166,166,166,166,166,166,166,166,166,166,166,166,166,166,166,166,166,166,166,166,166,166,166,166,166,166,166,166,166,166,166,272,272,272,272,272,272,272,272,272
166,166,166,166,166,166,166,166,166,166,166,166,166,166,166,34,166,166,166,166,166,166,166,166,170,188,188,188,171,273,273,166,166,166,166,166,166,166,166,166,166,166,166,166,166,166,166,166,166,166,166,166,166,166,166,166,166,166,166,166,166,166,166,166,166,166,166,166,166,166,166,166,272,272,272,272,272,272,272,272
166,166,166,166,166,166,166,166,166,166,166,166,166,166,166,34,166,166,166,166,166,166,170,188,189,264,264,264,187,188,188,171,166,166,166,166,166,166,166,166,166,166,166,166,166,166,166,166,166,166,166,166,166,166,166,166,166,166,166,166,166,166,166,166,166,166,166,166,166,166,166,166,272,272,272,272,272,272,272,272
166,166,166,34,34,166,166,166,166,166,166,166,166,166,166,34,166,170,188,188,188,188,189,264,264,264,264,264,264,264,264,187,171,166,166,166,166,166,166,166,166,166,166,166,166,166,166,166,166,166,166,166,166,166,166,166,166,166,166,166,166,166,166,166,166,166,166,166,166,166,166,166,272,272,272,272,272,272,272,272
166,166,166,166,166,166,166,166,166,166,166,166,166,166,166,166,166,167,264,264,264,264,264,264,268,264,264,264,264,264,264,264,165,166,166,166,166,166,166,166,166,166,166,166,166,166,166,166,166,166,166,166,166,166,166,166,166,166,166,166,166,166,166,166,166,166,166,166,166,166,166,166,166,272,272,272,272,272,272,272
166,166,166,166,166,166,166,166,166,166,166,166,166,166,166,166,166,167,264,264,264,264,264,268,268,264,264,264,268,268,264,264,165,166,166,166,166,166,166,166,166,166,166,166,166,166,166,166,166,166,166,166,166,166,166,166,166,166,166,166,166,166,166,166,166,166,166,166,166,166,166,166,166,166,166,272,272,272,272,272
166,166,166,166,166,166,166,166,166,166,166,166,166,166,166,170,188,189,264,264,264,264,268,264,264,264,264,264,268,264,264,264,165,166,166,166,166,166,166,166,166,166,166,166,166,166,166,166,166,166,166,166,166,166,166,166,166,166,166,166,166,166,166,166,271,166,166,166,166,166,166,166,166,166,166,166,166,166,272,272
166,166,166,166,166,166,166,166,166,166,166,252,166,166,170,189,265,264,264,264,264,265,264,264,264,264,268,268,268,264,264,264,165,166,166,166,166,166,166,166,166,166,166,166,166,166,166,166,166,166,166,166,166,166,166,166,166,166,166,166,166,166,166,166,166,166,166,166,166,166,166,166,166,166,166,166,166,166,166,166
166,166,166,166,166,166,166,166,166,166,166,166,166,252,167,265,264,264,264,264,264,265,264,264,264,268,268,264,264,264,264,264,165,166,166,166,166,166,166,166,166,166,166,166,166,166,166,166,166,166,166,166,166,166,166,166,166,166,166,166,166,166,166,166,166,166,166,166,166,166,166,166,166,166,166,166,166,166,166,166
166,166,166,166,166,166,273,252,273,166,166,252,166,166,167,265,264,264,264,264,264,265,264,264,265,268,264,264,264,264,264,143,193,166,166,166,166,166,166,166,166,166,166,166,166,166,166,166,166,166,166,271,166,166,166,166,166,166,166,166,166,166,166,166,166,166,166,166,166,166,166,166,166,166,166,166,166,166,166,166
166,166,166,166,166,252,273,273,273,286,287,287,354,188,1610612923,265,264,264,264,264,265,265,264,264,264,268,264,264,264,264,264,165,166,166,166,166,166,166,166,166,166,166,166,166,166,166,166,166,166,166,166,166,166,166,166,166,166,166,166,166,166,166,166,166,166,166,166,166,166,166,166,166,166,166,166,166,166,166,166,166
166,166,166,166,166,166,252,166,166,330,331,332,221,221,155,155,155,156,264,264,265,264,264,264,264,268,264,264,264,264,264,187,188,188,188,188,188,188,188,188,188,188,188,188,188,188,188,188,188,188,171,273,34,273,274,166,166,166,166,166,166,166,166,166,166,166,166,166,166,166,166,166,166,166,166,166,166,166,166,166
166,166,166,166,166,166,273,166,166,166,166,167,264,264,198,177,177,203,156,264,264,264,264,264,264,268,264,264,264,264,264,264,264,268,268,267,267,264,264,264,264,264,264,264,264,265,264,264,264,264,165,166,271,271,273,38,56,56,56,56,56,39,166,166,166,166,166,166,166,166,166,166,166,166,166,166,166,166,166,166
166,166,166,166,166,252,273,166,166,166,170,189,264,264,264,198,199,182,177,156,264,264,264,264,264,264,264,264,264,264,265,265,264,264,264,267,267,267,267,264,264,264,264,264,265,265,264,264,264,264,165,34,34,166,38,57,121,121,121,121,121,55,56,56,56,39,166,166,166,166,166,166,166,166,166,166,166,166,166,166
166,166,252,273,166,166,252,170,188,188,189,264,264,264,264,264,264,198,182,177,156,264,264,264,264,264,264,264,265,264,264,264,264,264,264,264,264,264,264,264,265,268,264,264,265,265,264,264,264,143,193,166,270,38,57,121,121,121,121,121,121,121,121,121,121,55,39,166,166,166,166,166,166,166,166,166,166,166,166,166
166,166,166,273,166,166,170,189,264,264,264,264,264,264,264,264,264,264,198,182,177,156,264,264,264,265,264,264,265,264,264,264,264,264,264,264,265,265,265,265,265,268,264,264,265,264,264,264,264,165,34,270,38,57,121,121,121,121,121,121,121,121,121,121,121,121,55,39,166,166,166,166,166,166,166,166,166,166,166,166
166,273,273,273,166,166,167,212,264,264,264,264,264,264,264,264,264,264,264,198,182,177,156,264,264,264,264,265,265,264,264,264,264,265,265,265,264,264,264,265,264,267,264,264,265,265,264,264,264,165,34,34,35,121,121,121,121,121,121,121,121,121,121,121,121,121,121,55,39,166,166,166,166,166,166,166,166,166,166,166
166,273,273,166,166,166,167,264,264,264,264,264,264,264,264,264,264,264,264,264,198,182,177,156,264,264,264,268,264,264,264,264,264,264,264,264,264,264,264,265,264,268,268,264,265,265,264,264,264,187,171,34,35,121,121,121,121,121,121,121,121,121,121,121,121,121,121,121,55,39,166,166,166,166,166,166,166,166,166,166
166,273,273,252,166,166,167,264,264,264,264,264,264,264,265,264,264,264,264,264,264,198,182,177,156,264,264,264,264,264,264,264,264,264,264,264,264,264,264,265,265,264,264,264,264,265,265,264,264,264,165,34,35,121,121,121,121,121,121,121,121,121,121,121,121,121,121,121,121,33,166,166,166,166,166,166,166,166,166,166
166,166,166,252,166,166,167,264,264,264,264,264,264,264,264,264,264,264,264,264,264,264,198,182,177,156,264,264,268,264,264,264,264,264,264,264,264,264,264,264,264,264,264,268,264,264,265,265,265,264,165,34,35,121,121,121,121,121,121,121,121,121,121,121,121,121,121,121,11,61,274,166,166,166,166,166,166,166,166,166
166,166,166,252,166,166,192,145,264,264,264,264,264,264,265,264,264,264,264,264,264,264,264,198,182,177,156,264,268,264,264,264,264,264,264,264,264,264,264,264,264,264,264,264,264,264,264,264,265,143,193,38,57,121,121,121,121,121,121,121,121,121,121,121,121,121,121,121,33,274,38,39,166,166,166,166,166,166,166,166
166,166,166,166,166,166,166,192,145,264,264,264,264,264,264,264,264,264,264,264,264,264,264,264,176,177,243,156,264,264,264,268,268,268,264,264,264,264,264,268,268,264,264,268,268,264,264,264,265,165,34,35,121,121,121,121,121,121,121,121,121,121,121,121,121,121,121,121,55,56,57,33,166,166,166,166,166,166,166,166
166,166,166,166,166,166,166,166,192,145,264,264,264,264,264,264,264,264,264,264,264,264,264,264,198,199,177,177,155,155,156,264,264,264,264,264,264,264,264,264,264,264,264,264,268,264,264,265,265,165,34,35,121,121,121,121,121,121,121,121,121,121,121,121,121,121,121,121,121,121,121,33,166,166,166,166,166,166,166,166
166,166,166,166,166,166,166,166,166,192,145,264,264,264,264,264,264,264,264,264,265,264,264,264,264,264,198,199,199,177,177,155,155,155,155,155,156,264,143,144,144,144,144,144,144,144,144,144,144,193,271,35,121,121,121,121,121,121,121,121,121,121,121,121,121,121,121,121,121,121,121,33,166,166,166,166,166,166,166,166
166,166,166,166,166,166,166,166,166,166,167,264,264,264,264,264,264,265,265,265,264,264,264,264,264,264,264,264,264,198,199,199,199,199,199,199,163,286,288,166,166,166,274,166,166,166,34,34,273,273,34,60,13,121,121,121,121,121,121,121,121,121,121,121,121,121,121,121,121,121,121,33,166,166,166,166,166,166,166,166
166,166,166,166,166,166,166,166,166,166,167,264,264,264,264,264,264,265,264,264,264,265,265,265,265,264,264,264,264,264,264,264,264,264,264,143,352,309,309,288,272,34,170,188,188,188,188,188,-1610612566,166,34,34,60,13,121,121,121,11,12,13,121,121,121,121,121,121,121,121,121,121,121,33,166,166,166,166,166,166,166,166
166,166,166,166,166,166,166,166,166,166,167,264,264,264,264,264,264,264,264,264,264,264,264,264,265,265,265,264,264,264,264,264,264,264,143,193,34,330,309,309,354,188,189,264,264,264,264,264,187,-1610612566,166,34,252,60,12,12,13,33,166,60,12,13,121,121,121,121,121,121,121,121,121,33,166,166,166,166,166,166,166,166
166,166,166,166,166,166,166,166,166,166,167,264,264,264,264,264,264,264,264,264,264,264,264,264,264,264,264,264,264,264,264,264,264,143,193,34,1610612907,189,330,332,203,156,264,264,264,264,264,264,264,187,188,188,171,252,252,270,60,61,166,166,166,60,13,121,121,121,121,121,121,121,121,33,166,166,166,166,166,166,166,166
166,166,166,166,166,166,166,166,166,166,167,264,264,264,264,264,264,264,264,264,264,264,264,264,264,264,264,264,264,264,264,264,143,193,34,170,189,264,198,182,177,203,155,155,155,156,264,264,264,268,264,264,187,188,188,188,171,34,34,34,166,166,60,13,121,121,121,121,121,121,121,33,166,166,166,166,166,166,166,166
166,166,166,166,166,166,166,170,188,188,189,264,264,264,265,265,265,265,265,265,265,264,264,264,264,264,264,264,264,264,264,143,-1610612565,34,1610612907,189,264,264,244,198,199,199,199,199,199,203,155,156,264,264,264,264,245,245,245,264,187,171,166,34,34,34,166,60,13,121,121,121,121,121,121,33,166,166,166,166,166,166,166,166
166,166,166,166,166,166,170,189,264,264,264,264,264,265,265,264,264,264,264,264,265,264,264,264,264,264,264,264,264,264,143,193,34,34,167,264,264,264,264,244,245,264,264,244,245,198,182,203,156,264,264,245,245,264,245,245,245,187,188,188,171,34,34,166,60,13,121,121,121,121,121,33,166,166,166,166,166,166,166,166
166,166,166,166,166,166,167,264,264,264,264,264,265,265,265,265,265,264,264,264,264,264,264,264,264,264,264,264,264,264,165,34,166,170,189,245,245,245,264,264,264,264,244,245,264,264,198,182,178,264,264,264,264,264,245,245,245,264,264,264,187,171,34,34,34,60,13,121,121,121,11,61,166,166,166,166,166,166,166,166
166,166,166,166,166,166,167,264,264,264,264,264,264,264,264,264,264,264,264,264,264,264,265,264,264,264,264,264,264,143,193,166,166,167,245,245,245,245,245,264,264,264,264,264,264,264,244,176,178,264,264,264,264,264,264,264,264,264,264,264,264,187,171,166,166,34,60,12,12,12,61,166,166,166,166,166,166,166,166,166
166,166,166,166,166,166,167,264,264,264,264,264,264,264,264,264,264,264,264,265,264,264,264,264,264,264,264,264,143,193,34,166,166,167,245,245,245,245,245,245,264,264,244,244,245,264,264,176,203,155,156,264,264,264,264,264,264,264,264,264,264,264,187,171,166,166,166,34,34,166,166,166,166,166,166,166,166,166,166,166
166,166,166,166,166,166,192,145,264,264,264,264,264,264,264,264,264,264,264,264,264,264,264,264,264,264,143,144,193,34,34,170,188,189,245,245,245,245,245,245,264,264,264,264,264,264,244,198,199,182,203,156,264,264,264,264,264,264,264,264,264,264,264,187,188,188,188,171,34,34,166,166,166,166,166,166,166,166,166,166
166,166,166,166,166,166,166,192,145,264,264,264,264,264,264,264,264,264,264,264,264,264,264,264,264,143,193,166,166,166,34,167,245,245,245,245,245,245,245,245,245,264,264,244,244,245,264,264,264,198,182,203,156,264,264,245,264,264,264,264,264,264,264,264,264,264,264,187,171,34,166,34,166,166,166,166,166,166,166,166
166,166,166,166,166,166,166,166,192,144,144,144,144,144,144,145,264,264,264,265,264,264,143,144,144,193,166,166,166,166,166,167,245,245,245,245,245,245,245,245,245,264,264,244,245,264,264,264,264,264,198,182,178,264,264,245,264,264,264,265,265,265,264,264,245,264,264,264,187,171,166,166,34,166,166,166,166,166,166,166
166,166,166,166,166,166,166,166,166,166,166,166,166,166,166,167,264,264,264,264,264,143,193,166,166,166,166,166,166,166,166,167,245,245,245,245,245,245,245,245,245,245,264,264,264,264,264,245,264,264,264,176,178,264,264,264,264,264,265,265,265,265,265,264,264,264,264,264,264,165,166,166,166,166,166,166,166,166,166,166
166,166,166,166,166,166,166,166,166,166,166,166,166,166,166,167,264,264,264,264,143,193,166,166,166,166,166,166,166,166,166,192,145,245,245,245,245,245,245,245,245,245,245,245,264,264,264,264,264,245,264,176,178,264,264,264,264,265,264,265,265,264,265,265,264,264,264,264,264,165,166,166,166,166,166,166,166,166,166,166
166,166,166,166,166,166,166,166,166,166,166,166,166,166,166,167,264,264,264,143,193,166,166,166,166,166,166,166,166,166,166,166,192,145,245,245,245,245,245,245,245,245,245,245,245,264,264,264,264,264,264,176,178,264,264,264,264,265,265,264,265,265,264,265,264,264,264,264,264,165,166,166,166,166,166,166,166,166,166,166
166,166,166,166,166,166,166,166,166,166,166,166,166,166,166,192,145,264,264,165,166,166,166,166,166,166,166,166,166,166,166,166,166,192,145,245,245,245,245,245,245,245,245,245,245,264,264,264,264,264,264,198,203,156,264,264,264,264,265,265,265,265,265,265,264,264,264,264,264,165,166,166,166,166,166,166,166,166,166,166
166,166,166,166,166,166,166,166,166,166,166,166,166,166,166,166,192,144,144,193,166,166,166,166,166,166,166,166,166,166,166,166,166,166,192,145,245,245,245,245,245,245,245,245,245,264,264,264,264,245,264,264,176,203,156,264,264,264,264,264,264,264,264,264,264,264,264,264,264,165,34,166,166,166,166,166,166,166,166,166
166,166,166,166,166,166,166,166,166,166,166,166,166,166,166,166,166,166,166,166,166,166,166,166,166,166,166,166,166,166,166,166,166,166,166,192,144,144,145,245,245,245,245,245,245,245,264,264,264,264,264,264,198,182,203,156,264,264,264,264,264,264,264,264,264,264,264,264,264,187,171,166,166,166,166,166,166,166,166,166
166,166,166,166,166,166,166,166,166,166,166,166,166,166,166,166,166,166,166,166,166,166,166,166,166,166,166,166,166,166,166,166,166,166,166,166,166,166,192,145,245,245,245,245,245,245,264,245,264,245,264,264,264,198,182,203,156,264,264,264,264,264,265,264,264,264,264,264,264,264,165,166,166,166,166,166,166,166,166,166
166,166,166,166,166,166,166,170,171,166,166,166,166,166,166,166,166,166,166,166,166,166,166,166,166,166,166,166,166,166,166,166,166,166,166,166,166,166,166,192,144,144,144,144,144,145,264,264,264,264,264,264,264,264,198,182,178,264,264,264,264,264,264,264,264,264,264,264,264,264,165,166,166,166,166,166,166,166,166,166
166,166,166,166,166,166,166,192,193,166,166,166,166,166,166,166,166,166,166,166,166,166,166,166,166,166,166,166,166,166,166,166,166,166,166,166,166,166,166,166,166,166,166,166,166,-1073741653,145,264,264,264,264,264,264,264,264,176,177,156,264,264,264,264,245,264,245,264,264,264,264,143,-1610612565,166,166,166,166,166,166,166,166,166
166,166,166,166,166,166,166,166,166,166,166,166,166,166,166,166,166,166,166,166,166,166,166,166,166,166,166,166,166,166,166,166,166,166,166,166,166,166,166,166,166,166,166,166,166,166,192,145,264,264,264,264,264,264,264,176,177,178,264,264,264,264,264,264,264,264,264,264,143,-1610612565,166,166,166,166,166,166,166,166,166,166
166,166,166,166,166,166,166,166,166,166,166,166,166,166,166,166,166,166,166,166,166,166,166,166,166,166,166,166,166,166,166,166,166,166,166,166,166,166,166,166,166,166,166,166,166,166,166,192,145,264,264,264,264,245,264,198,182,203,155,156,264,264,264,264,264,264,264,143,-1610612565,34,34,166,166,166,166,166,166,166,166,166
166,166,166,166,166,166,166,166,166,166,166,166,166,166,166,166,166,166,166,166,166,166,166,166,166,166,166,166,166,166,166,166,166,166,166,166,166,166,166,166,166,166,166,166,166,166,166,166,192,145,264,264,264,264,264,264,198,199,199,163,156,264,264,264,264,264,143,1610612928,34,34,166,166,166,166,166,166,166,166,166,166
166,166,166,166,166,166,166,166,166,166,166,166,166,166,166,166,166,166,166,166,166,166,166,166,166,166,166,166,166,166,166,166,166,166,166,166,166,166,166,166,166,166,166,166,166,166,166,166,166,192,145,264,264,264,264,264,264,264,264,198,163,156,264,264,264,143,-1610612565,34,34,166,166,166,166,166,166,166,166,166,166,166
166,166,166,166,166,166,166,166,166,166,166,166,166,166,166,166,166,166,166,166,166,166,166,166,166,166,166,166,166,166,166,166,166,166,166,166,166,166,166,166,274,274,274,166,166,166,166,166,166,166,192,144,145,264,264,264,264,264,245,264,176,178,264,264,143,1610612928,166,166,166,166,166,166,166,166,166,166,166,166,166,166
166,166,166,166,166,166,166,166,166,166,166,166,166,166,166,166,166,166,166,166,166,166,166,166,166,166,166,166,166,166,166,166,166,166,166,166,166,166,166,166,166,274,274,274,166,166,166,166,166,166,166,166,167,264,264,264,264,264,264,264,176,203,156,143,1610612928,166,166,166,166,166,166,166,166,166,166,166,166,166,166,166
166,166,166,166,166,166,166,166,166,166,166,166,166,166,166,166,166,166,166,166,166,166,166,166,166,166,166,166,166,166,166,166,166,166,166,166,166,166,166,166,166,274,274,274,274,166,166,166,166,166,166,166,167,264,264,264,264,264,264,264,176,177,286,288,252,166,166,166,166,274,166,166,166,166,166,166,166,166,166,166
166,166,166,166,166,166,166,166,166,166,166,166,166,166,166,166,166,166,166,166,166,166,166,166,166,166,166,166,166,166,166,166,166,166,166,166,166,166,166,166,166,274,274,274,166,166,166,166,166,166,166,166,167,264,264,264,264,264,264,264,198,286,309,309,288,273,166,166,271,274,166,166,274,274,166,166,166,166,166,166
166,166,166,166,166,166,166,166,166,166,166,166,166,166,166,166,166,166,166,166,166,166,166,166,166,166,166,166,166,166,166,166,166,166,166,166,166,166,166,166,166,273,274,166,166,166,166,166,166,166,166,166,167,264,264,264,264,264,264,264,143,330,309,309,309,288,166,271,166,274,274,274,274,166,166,166,166,166,166,166
166,166,166,166,166,166,166,166,166,166,166,274,166,166,166,166,166,166,166,166,166,166,166,166,166,166,166,166,166,166,166,166,166,166,166,166,166,166,166,166,166,166,166,166,166,166,166,166,166,166,166,166,167,264,264,264,264,264,264,143,-1610612565,252,330,309,309,309,288,166,270,270,274,274,166,166,166,166,166,166,166,166
166,166,166,166,166,166,166,166,166,166,166,166,166,166,166,166,166,166,166,166,166,166,166,166,166,166,166,166,166,166,166,166,166,166,166,166,166,166,166,166,166,166,166,166,166,166,166,166,166,166,166,166,192,144,144,144,144,144,144,-1610612565,166,166,166,330,331,331,332,274,274,274,274,166,166,274,166,166,166,166,166,166
166,166,166,166,166,166,166,166,166,166,166,166,166,166,166,166,166,166,166,166,166,166,166,166,166,166,166,166,166,166,166,166,166,166,166,166,166,166,166,166,166,166,166,166,166,166,166,166,166,166,166,166,166,166,166,166,166,166,166,166,166,166,271,166,273,274,274,274,274,274,274,274,274,274,166,166,166,166,166,166
166,166,166,166,166,166,166,166,166,166,166,166,166,166,166,166,166,166,166,166,166,166,166,166,166,166,166,166,166,166,166,166,166,166,166,166,166,166,166,166,166,166,166,166,166,166,166,166,166,166,166,166,166,166,166,166,166,166,166,166,166,166,166,166,270,274,274,270,274,270,274,274,166,166,166,166,166,166,166,166
166,166,166,166,166,166,166,166,166,166,166,166,166,166,166,166,166,166,166,166,166,166,166,166,166,166,166,166,166,166,166,166,166,166,166,166,166,166,166,166,166,166,166,166,166,166,166,166,166,166,166,166,166,166,166,166,166,166,166,166,166,166,272,274,274,274,166,271,274,270,274,166,166,166,166,166,166,166,166,166
166,166,166,166,166,166,166,166,166,166,166,166,166,166,166,166,166,166,166,166,166,166,166,166,166,166,166,166,166,166,166,166,166,166,166,166,166,166,166,166,166,166,166,166,166,166,166,166,166,166,166,166,166,166,166,166,166,166,166,166,274,274,274,274,271,166,274,274,274,274,274,166,166,166,166,166,166,166,166,166
166,166,166,166,166,166,166,166,166,166,166,166,166,166,166,166,166,166,166,166,166,166,166,166,166,166,166,166,166,166,166,166,166,166,166,166,166,166,166,166,166,166,166,166,166,166,166,166,166,166,166,166,166,166,166,166,166,166,166,166,274,274,166,166,166,166,272,166,166,166,274,166,166,166,166,166,166,166,166,166
166,166,166,166,166,166,166,166,166,166,166,166,166,166,166,166,166,166,166,166,166,166,166,166,166,166,166,166,166,166,166,166,166,166,166,166,166,166,166,166,166,166,166,166,166,166,166,166,166,166,166,166,166,166,166,166,166,166,166,166,166,166,166,166,166,166,166,166,166,274,274,166,166,166,166,166,166,166,166,166
166,166,166,166,166,166,166,166,166,166,166,166,166,166,166,166,166,166,166,166,166,166,166,166,166,166,166,166,166,166,166,166,166,166,166,166,166,166,166,166,166,166,166,166,166,166,166,166,166,166,166,166,166,166,166,166,166,166,166,166,166,166,166,166,166,166,166,166,166,166,166,166,166,166,166,166,166,166,166,166
166,166,166,166,166,166,166,166,166,166,166,166,166,166,166,166,166,166,166,166,166,166,166,166,166,166,166,166,166,166,166,166,166,166,166,166,166,166,166,166,166,166,166,166,166,166,166,166,166,166,166,166,166,166,166,166,166,166,166,166,166,166,166,166,166,166,166,166,166,166,166,166,166,166,166,166,166,166,166,166
